NO textures/t.xpm  
SO textures/t.xpm
WE textures/t.xpm
EA textures/t.xpm

F     0 , 0 , 0
C 0,0,0

11111
10N01
10001
10101
11111
