NO textures/hamza.xpm  
SO textures/t.xpm
WE textures/hamza.xpm
EA textures/t.xpm

F     0 , 0 , 0
C 0,0,0

111111111
1010N0001
100000111
10100001
111111111
