NO                                              textures/monaliza_xpm.xpm  
SO textures/monaliza_xpm.xpm
WE textures/monaliza_xpm.xpm
EA textures/monaliza_xpm.xpm

F     0 , 0 , 0
C 0,0,0

111111111111111111111111111111111111111111111111111111
100N00000000000000000000000000000000000000000000000001
101010000000000000000000000000000000000000000000000001
100000000000000000000000000000000000000000000000000001
111111111111111111111111111111111111111111111111111111