NO textures/t0.xpm  
SO textures/t0.xpm 
WE textures/t0.xpm 
EA textures/t0.xpm 

F     0 , 0 , 0
C 0,0,0

111111111
101000001
1000W0111
10100001
111111111
