NO                                              textures/i4.png 
SO textures/i1.png
WE textures/i2.png
EA textures/i3.png

F     0 , 0 , 0
C 0,0,0

1111111111111111111111111111111
1000000000000000000000000000001
1000000000000S00000000000000001
1010000000000001000000000000001
1111111111111111111111111111111
