NO                                              textures/matrix.xpm
SO textures/matrix.xpm
WE textures/matrix.xpm
EA textures/matrix.xpm

F     0 , 0 , 0
C 0,0,0

    1111111111111111111
    100N000000000000001
    1010100000000000001
    10000000000000000001
    11111111111111111111