F 44, 62, 80
C 44, 62, 80

NO ../textures/h3.png
SO ../textures/h3.png
WE ../textures/h3.png
EA ../textures/h3.png

1111111111111111111
1001001001001000001
1011000001000001001
1001001001111101111
1001111000001001001
10000000N0000001001
1001111111111001001
1100000000000001011
1000000001000000001
1111111111111111111