NO                                              textures/matrix.xpm
SO textures/matrix.xpm
WE textures/matrix.xpm
EA textures/matrix.xpm

F     0 , 0 , 0
C 0,0,0



11111111111111111111111111111111111111111111111111111111111111111111111111111111111111111111111111
10011000000000000000000000000000000000000000000000000000000000000000000111111100000000000000000001
1000011111100000N000000000000000000000000000000000110000000000000000000000000000000000000000000011
10000000000000000000000000000000000000000000000001000100000000000000000000000111110000000000000011
10000000000011111111111111100000000000000000000010000000000100000000000000000000000000000000000011
10000000000000000000000000000000000000000000000000000000000000000000000000001111100000000000000011
10000000111111100000000000000000000000000000000000011111111100000000000000000000000000000000000011
11111111111111111111111111111111111111111111111111111111111111111111111111111111111111111111111111


