NO                                              textures/matrix.xpm
SO textures/matrix.xpm
WE textures/matrix.xpm
EA textures/matrix.xpm

F     0 , 0 , 0
C 0,0,0

1111111
100N001
1010101
1000001
1111111