NO                                              textures/i4.png 
SO textures/i1.png
WE textures/i2.png
EA textures/i3.png

F     255 , 255 , 0
C 255,255,0

11111111111111111
10000N00001100001
10110000011100001
11110111000111011
10010000000000001
10000000001100001
10110000011100001
11111111111111111
