NO                                              textures/pic1.png 
SO textures/pic1.png
WE textures/pic2.png
EA textures/pic3.png

F     150 , 0 , 0 
C 		0,255,255

1111111111111111111111111111111111111111111111111111
10000S0000110000000000000000000000000000000000000001
1011000001110000000000000000000000000000000000000001
1111011100011101111111111111111111111111111111111111
1001000000000000000000000000000000000000000000000001
1000000000110000000000000000000000000000000000000001
1011000001110000000000000000000000000000000000000001
1111111111111111111111111111111111111111111111111111
